1111111111111111
1C0000C00000CC01
10E011100C000001
1P000011000C0001
1000C00000000001
10000C0001000001
10000C0001000001
1000000001000001
100001C00C000001
1000001101000011
1111111111111111