11111111111
1C0000C0001
10E01110001
1P000010001
10000000001
11111111111