11111111111
1C0000C0001
10E01110001
1P010010001
10010000001
11101111111